..##..S..T
#T##S.###.
#.###E###E
#.E...###.
###T#####G
