S.#E..S..T
.T##S.###.
E.###E###E
#.E...###.
###T#####G